NO ./src/img/floor_minimap.xpm
SO ./src/img/mini_player.xpm
WE ./src/img/wall_minimap.xpm
EA ./src/img/work_texture.xpm

F 0,255,0
C 0,0,255

1111111111111111111111111
100000N000110000000000001
1011000001110000000000001
100100000000000000000000111111111
111111111011000001110000000000001
100000000011000001110111111111111
11110111111111011100000010001
11110111111111011101010010001
11001000110101011100000000001
100100000000000001100000000001
10001000000000001101010000001
1100000111010101111101111000111
11110111 1110101 101111010001
11111111 1111111 111111111111

