

NO	./qwdqwdqwdqwd.xpm
SO  ./path_to_the_south_texture.xpm
WE ./path_to_the_west_texture.xpm
EA ./path_to_the_east_texture.xpm

C 0,0,255
F 0,255,0

111111111111111111111111
100000000000000000000001
100000000000000000000001
100000000000000000000001
100000000001000000000001
100000000000000000000001
100000000100000000000001
100000011100000000000001
100000000100000000000001
100000000100000000000001
100001110000000000000001
10000000N000000000000001
100000000000000000000001
111111111111111111111111