

NO ./path_to_the_north_texture.xpm 
SO  ./path_to_the_south_texture.xpm
WE ./path_to_the_west_texture.xpm
EA ./path_to_the_east_texture.xpm

C 0,254,1
F 255,0,4

        1111111111111111111111111
        1000000000110000000000001
       1011000001110000000000001
        1001000000000000000000001
111111111011000001110000000000001
100000000011000001110111111111111
1111011111111101110000001001
11110111111111011101010010001
110000001101010111000000100S1
10000000000000001100010001001      
10000000000000001101000010001
1100000111010101111101111000111
11110111 1110101 101111010001
11111111 1111111 111111111111
