

NO ./path_to_the_north_texture.xpm 
SO  ./path_to_the_south_texture.xpm
WE ./path_to_the_west_texture.xpm
EA ./path_to_the_east_texture.xpm

C 0,254,1
F 0,0,200

111111111111111111111111
100000000000000000000001
100000000000000000000001
100000000000000000000001
100000000001000000000001
100000000000000000000001
100000000000000000000001
100000000000000000000001
10000000000000000000001
100000000000000000000001
100000001000000000000001
10000000N000000000000001
100000000000000000000001
111111111111111111111111